Customer ID,Order Date,Recency,Frequency,Monetary,R_Score,F_Score,M_Score,RFM_Score,Rank
AA-10315,2017/6/29,184,5,5563.56,2,2,5,9,Loyal
AA-10375,2017/12/11,19,9,1056.39,5,5,2,12,Loyal
AA-10480,2017/4/15,259,4,1790.51,1,1,3,5,Risk
AA-10645,2017/11/5,55,6,5086.94,3,3,5,11,Loyal
AB-10015,2016/11/10,415,3,886.15,1,1,1,3,Risk
AB-10060,2017/11/6,54,8,7755.63,3,4,5,12,Loyal
AB-10105,2017/11/19,41,10,14473.57,4,5,5,14,VIP
AB-10150,2017/11/19,41,5,966.71,4,2,2,8,Potential
AB-10165,2017/12/5,25,8,1113.85,5,4,2,11,Loyal
AB-10255,2017/7/17,166,9,914.53,2,5,1,8,Potential
AB-10600,2017/11/10,50,4,1515.86,4,1,2,7,Potential
AC-10420,2017/5/12,232,3,925.8,1,1,1,3,Risk
AC-10450,2017/12/19,11,7,5527.85,5,3,5,13,VIP
AC-10615,2017/12/24,6,5,2537.69,5,2,3,10,Loyal
AC-10660,2017/3/23,282,5,657.31,1,2,1,4,Risk
AD-10180,2017/12/1,29,8,6106.88,4,4,5,13,VIP
AF-10870,2017/11/19,41,7,2052.91,4,3,3,10,Loyal
AF-10885,2016/11/10,415,4,861.57,1,1,1,3,Risk
AG-10270,2017/3/27,278,5,2582.9,1,2,3,6,Potential
AG-10300,2017/9/3,118,4,367.55,2,1,1,4,Risk
AG-10330,2017/12/22,8,5,660.97,5,2,1,8,Potential
AG-10390,2017/9/7,114,5,200.95,2,2,1,5,Risk
AG-10495,2017/10/13,78,8,2356.86,3,4,3,10,Loyal
AG-10525,2015/9/7,845,4,1455.04,1,1,2,4,Risk
AG-10675,2017/9/24,97,7,3489.06,3,3,4,10,Loyal
AG-10765,2017/10/14,77,4,170.59,3,1,1,5,Risk
AG-10900,2017/9/25,96,10,4510.79,3,5,5,13,VIP
AH-10030,2017/12/18,12,7,1744.7,5,3,3,11,Loyal
AH-10075,2017/11/26,34,10,3239.87,4,5,4,13,VIP
AH-10120,2017/10/31,60,7,1735.53,3,3,2,8,Potential
AH-10195,2017/11/5,55,4,1587.45,3,1,2,6,Potential
AH-10210,2017/12/24,6,9,4805.35,5,5,5,15,VIP
AH-10465,2017/5/14,230,5,2495.4,1,2,3,6,Potential
AH-10585,2017/12/9,21,4,738.5,5,1,1,7,Potential
AH-10690,2016/11/15,410,12,7888.3,1,5,5,11,Loyal
AI-10855,2017/12/17,13,10,4375.79,5,5,5,15,VIP
AJ-10780,2017/10/16,75,7,4867.34,3,3,5,11,Loyal
AJ-10795,2017/7/17,166,7,4501.39,2,3,5,10,Loyal
AJ-10945,2017/10/6,85,7,1839.24,3,3,3,9,Loyal
AJ-10960,2017/10/17,74,3,629.25,3,1,1,5,Risk
AM-10360,2017/12/2,28,5,814.01,4,2,1,7,Potential
AM-10705,2017/7/21,162,8,5664.02,2,4,5,11,Loyal
AO-10810,2016/8/16,501,1,161.28,1,1,1,3,Risk
AP-10720,2017/11/19,41,8,1638.55,4,4,2,10,Loyal
AP-10915,2017/9/23,98,10,3323.55,3,5,4,12,Loyal
AR-10345,2017/9/10,111,4,1055.69,2,1,2,5,Risk
AR-10405,2017/8/27,125,5,2236.12,2,2,3,7,Potential
AR-10510,2017/12/16,14,5,264.87,5,2,1,8,Potential
AR-10540,2017/12/24,6,6,6608.45,5,3,5,13,VIP
AR-10570,2016/7/14,534,1,88.15,1,1,1,3,Risk
AR-10825,2017/11/2,58,8,4523.33,3,4,5,12,Loyal
AS-10045,2017/10/3,88,7,3050.69,3,3,4,10,Loyal
AS-10090,2017/12/2,28,9,3255.3,4,5,4,13,VIP
AS-10135,2017/11/19,41,2,58.82,4,1,1,6,Potential
AS-10225,2017/12/8,22,5,4260.78,5,2,4,11,Loyal
AS-10240,2017/6/21,192,7,584.62,2,3,1,6,Potential
AS-10285,2017/12/11,19,6,3214.24,5,3,4,12,Loyal
AS-10630,2017/9/29,92,7,833.41,3,3,1,7,Potential
AT-10435,2017/12/9,21,6,1171.81,5,3,2,10,Loyal
AT-10735,2017/12/17,13,10,3831.87,5,5,4,14,VIP
AW-10840,2017/12/10,20,4,649.37,5,1,1,7,Potential
AW-10930,2017/11/14,46,7,2852.95,4,3,4,11,Loyal
AY-10555,2017/12/16,14,4,497.02,5,1,1,7,Potential
AZ-10750,2017/7/23,160,6,1622.03,2,3,2,7,Potential
BB-10990,2017/9/16,105,5,744.33,2,2,1,5,Risk
BB-11545,2017/12/2,28,9,6765.73,4,5,5,14,VIP
BC-11125,2017/6/11,202,9,2933.67,2,5,4,11,Loyal
BD-11320,2017/11/27,33,12,5718.53,4,5,5,14,VIP
BD-11500,2017/11/25,35,6,4411.25,4,3,5,12,Loyal
BD-11560,2017/3/27,278,2,320.54,1,1,1,3,Risk
BD-11605,2017/9/24,97,7,3288.48,3,3,4,10,Loyal
BD-11620,2017/10/22,69,6,1538.12,3,3,2,8,Potential
BD-11635,2017/12/21,9,3,582.65,5,1,1,7,Potential
BD-11725,2017/9/28,93,6,1526.5,3,3,2,8,Potential
BD-11770,2017/2/6,327,6,658.46,1,3,1,5,Risk
BE-11335,2017/9/2,119,5,4204.68,2,2,4,8,Potential
BE-11410,2017/9/23,98,5,2261.44,3,2,3,8,Potential
BE-11455,2017/4/20,254,6,1727.65,1,3,2,6,Potential
BF-10975,2017/9/30,91,7,599.79,3,3,1,7,Potential
BF-11005,2017/11/21,39,4,1333.89,4,1,2,7,Potential
BF-11020,2017/10/17,74,8,2888.5,3,4,4,11,Loyal
BF-11080,2017/12/5,25,3,272.95,5,1,1,7,Potential
BF-11170,2017/12/14,16,11,5907.97,5,5,5,15,VIP
BF-11215,2017/10/26,65,4,1585.17,3,1,2,6,Potential
BF-11275,2017/11/3,57,3,791.99,3,1,1,5,Risk
BG-11035,2017/12/2,28,8,2798.96,4,4,4,12,Loyal
BG-11695,2017/11/24,36,6,1874.18,4,3,3,10,Loyal
BG-11740,2017/11/3,57,6,1006.35,3,3,2,8,Potential
BH-11710,2017/12/7,23,8,6255.34,5,4,5,14,VIP
BK-11260,2017/10/14,77,6,659.15,3,3,1,7,Potential
BM-11140,2017/2/26,307,4,11789.64,1,1,5,7,Potential
BM-11575,2017/9/21,100,6,808.16,3,3,1,7,Potential
BM-11650,2017/11/27,33,11,7294.18,4,5,5,14,VIP
BM-11785,2017/5/26,218,10,1338.82,2,5,2,9,Loyal
BN-11470,2017/12/6,24,4,265.31,5,1,1,7,Potential
BN-11515,2017/12/21,9,5,1419.16,5,2,2,9,Loyal
BO-11350,2017/8/15,137,5,2682.73,2,2,3,7,Potential
BO-11425,2017/10/16,75,2,130.83,3,1,1,5,Risk
BP-11050,2017/10/8,83,5,983.42,3,2,2,7,Potential
BP-11095,2017/12/13,17,12,2442.05,5,5,3,13,VIP
BP-11155,2017/10/2,89,6,1697.87,3,3,2,8,Potential
BP-11185,2017/12/29,1,9,3675.86,5,5,4,14,VIP
BP-11230,2017/11/21,39,5,1181.49,4,2,2,8,Potential
BP-11290,2017/12/18,12,7,2475.16,5,3,3,11,Loyal
BS-11365,2016/6/20,558,5,10501.65,1,2,5,8,Potential
BS-11380,2017/12/2,28,5,3887.82,4,2,4,10,Loyal
BS-11590,2017/11/25,35,6,2454.93,4,3,3,10,Loyal
BS-11665,2016/5/27,582,3,3288.12,1,1,4,6,Potential
BS-11755,2017/12/29,1,7,2550.62,5,3,3,11,Loyal
BS-11800,2017/4/9,265,2,949.43,1,1,1,3,Risk
BT-11305,2017/1/28,336,5,2567.66,1,2,3,6,Potential
BT-11395,2017/3/3,302,6,2186.61,1,3,3,7,Potential
BT-11440,2016/6/18,560,4,603.87,1,1,1,3,Risk
BT-11485,2016/3/11,659,2,415.2,1,1,1,3,Risk
BT-11530,2017/9/30,91,5,2684.5,3,2,3,8,Potential
BT-11680,2017/12/10,20,7,3196.75,5,3,4,12,Loyal
BV-11245,2017/1/30,334,5,1523.28,1,2,2,5,Risk
BW-11065,2017/6/1,212,3,385.51,2,1,1,4,Risk
BW-11110,2017/8/31,121,8,4696.54,2,4,5,11,Loyal
BW-11200,2017/6/10,203,6,1738.41,2,3,2,7,Potential
CA-11965,2017/9/25,96,6,3789.72,3,3,4,10,Loyal
CA-12055,2016/11/24,401,5,1679.72,1,2,2,5,Risk
CA-12265,2017/11/4,56,9,2648.29,3,5,3,11,Loyal
CA-12310,2017/12/17,13,4,1421.96,5,1,2,8,Potential
CA-12775,2017/9/1,120,7,3041.58,2,3,4,9,Loyal
CB-12025,2017/11/13,47,10,6076.15,4,5,5,14,VIP
CB-12415,2017/12/4,26,8,1949.21,5,4,3,12,Loyal
CB-12535,2017/6/16,197,8,4246.46,2,4,4,10,Loyal
CC-12100,2016/9/29,457,6,1770.95,1,3,3,7,Potential
CC-12145,2017/9/15,106,7,2471.65,2,3,3,8,Potential
CC-12220,2017/12/10,20,12,3913.43,5,5,4,14,VIP
CC-12370,2017/11/17,43,5,12129.08,4,2,5,11,Loyal
CC-12430,2017/12/30,0,10,2870.05,5,5,4,14,VIP
CC-12475,2017/11/21,39,9,1659.45,4,5,2,11,Loyal
CC-12550,2017/12/3,27,3,113.84,4,1,1,6,Potential
CC-12610,2017/11/26,34,7,2540.63,4,3,3,10,Loyal
CC-12670,2017/12/1,29,7,2269.69,4,3,3,10,Loyal
CC-12685,2015/10/23,799,4,2854.12,1,1,4,6,Potential
CD-11920,2017/11/20,40,5,2033.97,4,2,3,9,Loyal
CD-11980,2017/11/6,54,3,639.76,3,1,1,5,Risk
CD-12280,2017/11/18,42,2,1205.58,4,1,2,7,Potential
CD-12790,2016/11/26,399,5,1860.74,1,2,3,6,Potential
CG-12040,2017/11/11,49,6,904.48,4,3,1,8,Potential
CG-12520,2017/1/26,338,3,1148.78,1,1,2,4,Risk
CH-12070,2016/2/8,691,3,1537.24,1,1,2,4,Risk
CJ-11875,2016/12/30,365,1,16.52,1,1,1,3,Risk
CJ-12010,2017/6/24,189,8,11164.97,2,4,5,11,Loyal
CK-12205,2017/11/21,39,13,3154.83,4,5,4,13,VIP
CK-12325,2017/9/1,120,5,2945.32,2,2,4,8,Potential
CK-12595,2017/11/17,43,11,2341.31,4,5,3,12,Loyal
CK-12760,2017/10/9,82,9,1582.11,3,5,2,10,Loyal
CL-11890,2017/9/15,106,4,1262.01,2,1,2,5,Risk
CL-12565,2017/3/21,284,12,10880.56,1,5,5,11,Loyal
CL-12700,2017/9/16,105,5,2353.59,2,2,3,7,Potential
CM-11815,2017/8/21,131,6,1673.89,2,3,2,7,Potential
CM-11935,2016/1/22,708,2,565.39,1,1,1,3,Risk
CM-12115,2017/12/22,8,4,1661.61,5,1,2,8,Potential
CM-12160,2017/12/4,26,6,2533.32,5,3,3,11,Loyal
CM-12190,2017/12/22,8,6,1475.14,5,3,2,10,Loyal
CM-12235,2016/12/10,385,5,2305.71,1,2,3,6,Potential
CM-12385,2017/11/23,37,4,8954.01,4,1,5,10,Loyal
CM-12445,2016/10/20,436,3,288,1,1,1,3,Risk
CM-12655,2017/12/3,27,6,6339.56,4,3,5,12,Loyal
CM-12715,2015/3/1,1035,4,3984.45,1,1,4,6,Potential
CP-12085,2017/10/9,82,8,5402.25,3,4,5,12,Loyal
CP-12340,2017/7/23,160,8,5888.3,2,4,5,11,Loyal
CR-12580,2017/11/3,57,4,2141.19,3,1,3,7,Potential
CR-12625,2016/9/16,470,3,475.9,1,1,1,3,Risk
CR-12730,2017/10/13,78,4,1600.55,3,1,2,6,Potential
CR-12820,2017/10/6,85,3,1397.88,3,1,2,6,Potential
CS-11845,2017/9/30,91,5,1278.96,3,2,2,7,Potential
CS-11860,2017/7/21,162,6,537.63,2,3,1,6,Potential
CS-11950,2017/12/5,25,11,3036.53,5,5,4,14,VIP
CS-12130,2016/8/28,489,4,866.7,1,1,1,3,Risk
CS-12175,2017/5/12,232,5,844.46,1,2,1,4,Risk
CS-12250,2017/12/4,26,12,2754.22,5,5,4,14,VIP
CS-12355,2017/12/24,6,11,3202.16,5,5,4,14,VIP
CS-12400,2017/12/28,2,9,3651.86,5,5,4,14,VIP
CS-12460,2017/12/3,27,2,550.64,4,1,1,6,Potential
CS-12490,2016/11/1,424,4,1077.23,1,1,2,4,Risk
CS-12505,2017/11/2,58,6,5690.07,3,3,5,11,Loyal
CT-11995,2017/9/25,96,8,3241.9,3,4,4,11,Loyal
CV-12295,2017/4/20,254,5,2830.63,1,2,4,7,Potential
CV-12805,2017/12/25,5,9,2370.33,5,5,3,13,VIP
CW-11905,2017/12/8,22,6,1136.59,5,3,2,10,Loyal
CY-12745,2017/10/31,60,8,2900.02,3,4,4,11,Loyal
Co-12640,2016/6/29,549,5,1300.08,1,2,2,5,Risk
DA-13450,2017/1/12,352,4,156.76,1,1,1,3,Risk
DB-12910,2017/12/9,21,8,2171.61,5,4,3,12,Loyal
DB-12970,2017/5/3,241,5,2839.23,1,2,4,7,Potential
DB-13060,2017/12/14,16,7,4531.65,5,3,5,13,VIP
DB-13120,2017/11/12,48,7,2973.09,4,3,4,11,Loyal
DB-13210,2017/12/21,9,10,2332.57,5,5,3,13,VIP
DB-13270,2017/11/7,53,8,4655.9,4,4,5,13,VIP
DB-13360,2017/4/10,264,5,1081.47,1,2,2,5,Risk
DB-13405,2017/6/26,187,4,1711.69,2,1,2,5,Risk
DB-13555,2017/9/14,107,7,3908.8,2,3,4,9,Loyal
DB-13615,2017/11/27,33,7,1989.05,4,3,3,10,Loyal
DB-13660,2017/12/18,12,7,1155.21,5,3,2,10,Loyal
DC-12850,2017/11/23,37,9,3314.19,4,5,4,13,VIP
DC-13285,2017/12/7,23,5,1174.62,5,2,2,9,Loyal
DD-13570,2017/11/19,41,6,240.13,4,3,1,8,Potential
DE-13255,2016/1/11,719,5,2550.87,1,2,3,6,Potential
DF-13135,2016/1/30,700,3,2390.54,1,1,3,5,Risk
DG-13300,2017/11/28,32,5,3195.82,4,2,4,10,Loyal
DH-13075,2017/3/28,277,6,4932.87,1,3,5,9,Loyal
DH-13675,2015/11/15,776,4,1043.09,1,1,2,4,Risk
DJ-13420,2016/4/2,637,4,2012.52,1,1,3,5,Risk
DJ-13510,2017/11/12,48,8,2501.69,4,4,3,11,Loyal
DJ-13630,2017/12/18,12,3,3356.4,5,1,4,10,Loyal
DK-12835,2017/12/9,21,12,3256.48,5,5,4,14,VIP
DK-12895,2017/11/15,45,5,4282.16,4,2,5,11,Loyal
DK-12985,2017/12/23,7,5,1687.03,5,2,2,9,Loyal
DK-13090,2017/11/18,42,7,2650.55,4,3,3,10,Loyal
DK-13150,2017/12/20,10,2,797.83,5,1,1,7,Potential
DK-13225,2017/12/20,10,9,4802.39,5,5,5,15,VIP
DK-13375,2017/12/11,19,8,3318.49,5,4,4,13,VIP
DL-12865,2017/9/21,100,8,1503.12,3,4,2,9,Loyal
DL-12925,2017/11/3,57,6,3272.2,3,3,4,10,Loyal
DL-13315,2017/12/8,22,8,1458.25,5,4,2,11,Loyal
DL-13330,2017/11/3,57,4,585.02,3,1,1,5,Risk
DL-13495,2017/10/15,76,8,3539.32,3,4,4,11,Loyal
DM-12955,2017/9/7,114,7,1322.03,2,3,2,7,Potential
DM-13015,2017/11/3,57,7,6345.09,3,3,5,11,Loyal
DM-13345,2017/12/8,22,8,4074.47,5,4,4,13,VIP
DM-13525,2016/9/5,481,3,1376.8,1,1,2,4,Risk
DN-13690,2017/5/27,217,7,2139.79,2,3,3,8,Potential
DO-13435,2017/8/19,133,9,1300.03,2,5,2,9,Loyal
DO-13645,2017/12/4,26,7,1267.32,5,3,2,10,Loyal
DP-13000,2017/8/26,126,9,1050.63,2,5,2,9,Loyal
DP-13105,2017/12/24,6,8,2214.99,5,4,3,12,Loyal
DP-13165,2015/10/10,812,2,1058.62,1,1,2,4,Risk
DP-13390,2017/1/6,358,9,5480.73,1,5,5,11,Loyal
DR-12880,2017/12/27,3,9,6528.03,5,5,5,15,VIP
DR-12940,2017/11/10,50,8,8350.87,4,4,5,13,VIP
DS-13030,2017/9/28,93,4,1762.21,3,1,3,7,Potential
DS-13180,2017/12/7,23,9,2881.8,5,5,4,14,VIP
DV-13045,2017/12/11,19,5,1119.48,5,2,2,9,Loyal
DV-13465,2017/12/1,29,6,3341.58,4,3,4,11,Loyal
DW-13195,2017/10/22,69,6,1080.76,3,3,2,8,Potential
DW-13480,2017/5/27,217,5,5271.63,2,2,5,9,Loyal
DW-13540,2017/9/23,98,5,344.08,3,2,1,6,Potential
DW-13585,2017/5/2,242,7,1204.85,1,3,2,6,Potential
Dl-13600,2017/9/2,119,5,755.6,2,2,1,5,Risk
Dp-13240,2017/10/7,84,11,7198.77,3,5,5,13,VIP
EA-14035,2017/7/31,152,13,2846.71,2,5,4,11,Loyal
EB-13705,2017/11/12,48,9,3644.97,4,5,4,13,VIP
EB-13750,2017/11/25,35,10,3236.32,4,5,4,13,VIP
EB-13840,2017/10/1,90,5,4358.13,3,2,5,10,Loyal
EB-13870,2017/9/21,100,10,2767.22,3,5,4,12,Loyal
EB-13930,2017/7/22,161,5,944.6,2,2,1,5,Risk
EB-13975,2017/12/30,0,4,1643.26,5,1,2,8,Potential
EB-14110,2017/9/8,113,6,3071.14,2,3,4,9,Loyal
EB-14170,2017/10/9,82,6,1186.33,3,3,2,8,Potential
EC-14050,2017/11/7,53,5,461.91,4,2,1,7,Potential
ED-13885,2017/8/17,135,8,3484.91,2,4,4,10,Loyal
EG-13900,2017/12/8,22,5,1832.02,5,2,3,10,Loyal
EH-13765,2017/8/17,135,12,10310.87,2,5,5,12,Loyal
EH-13945,2017/5/27,217,8,684.18,2,4,1,7,Potential
EH-13990,2016/11/20,405,6,825.95,1,3,1,5,Risk
EH-14005,2017/12/28,2,7,1219.52,5,3,2,10,Loyal
EH-14125,2017/7/31,152,10,3082.64,2,5,4,11,Loyal
EH-14185,2017/9/16,105,6,923.88,2,3,1,6,Potential
EJ-13720,2017/3/3,302,4,2162.18,1,1,3,5,Risk
EJ-14155,2017/11/3,57,5,2656.69,3,2,3,8,Potential
EK-13795,2017/11/16,44,4,1303.48,4,1,2,7,Potential
EL-13735,2017/10/14,77,2,124.28,3,1,1,5,Risk
EM-13810,2017/8/20,132,5,2567,2,2,3,7,Potential
EM-13825,2017/11/5,55,8,2339.6,3,4,3,10,Loyal
EM-13960,2017/8/1,151,5,933.7,2,2,1,5,Risk
EM-14065,2017/11/13,47,4,228.99,4,1,1,6,Potential
EM-14095,2017/9/8,113,4,1041.04,2,1,2,5,Risk
EM-14140,2017/11/12,48,6,4588.44,4,3,5,12,Loyal
EM-14200,2017/7/25,158,3,366.83,2,1,1,4,Risk
EN-13780,2017/3/18,287,4,2199.36,1,1,3,5,Risk
EP-13915,2017/12/18,12,17,5478.06,5,5,5,15,VIP
ER-13855,2016/11/4,421,3,1245.79,1,1,2,4,Risk
ES-14020,2017/11/20,40,5,3510.46,4,2,4,10,Loyal
ES-14080,2017/12/2,28,9,4657.93,4,5,5,14,VIP
FA-14230,2017/9/24,97,7,2984.05,3,3,4,10,Loyal
FC-14245,2017/10/21,70,7,3418.74,3,3,4,10,Loyal
FC-14335,2017/6/29,184,7,3889.36,2,3,4,9,Loyal
FG-14260,2017/11/26,34,7,1383.13,4,3,2,9,Loyal
FH-14275,2017/11/23,37,10,4256.28,4,5,4,13,VIP
FH-14350,2017/6/1,212,4,2271.29,2,1,3,6,Potential
FH-14365,2017/12/25,5,8,6987.2,5,4,5,14,VIP
FM-14215,2017/12/23,7,10,2415.48,5,5,3,13,VIP
FM-14290,2017/11/24,36,9,3736.2,4,5,4,13,VIP
FM-14380,2017/8/7,145,9,2523.26,2,5,3,10,Loyal
FO-14305,2017/11/22,38,10,2678.43,4,5,3,12,Loyal
FP-14320,2017/12/7,23,8,4046.75,5,4,4,13,VIP
FW-14395,2017/1/2,362,3,79.75,1,1,1,3,Risk
GA-14515,2017/8/3,149,8,3919.77,2,4,4,10,Loyal
GA-14725,2017/12/25,5,11,1398.39,5,5,2,12,Loyal
GB-14530,2017/10/29,62,11,1568.44,3,5,2,10,Loyal
GB-14575,2017/12/17,13,5,4716.3,5,2,5,12,Loyal
GD-14590,2017/12/25,5,4,1888.08,5,1,3,9,Loyal
GG-14650,2017/11/17,43,9,2223.99,4,5,3,12,Loyal
GH-14410,2017/10/16,75,9,2819.46,3,5,4,12,Loyal
GH-14425,2017/11/10,50,4,4172.84,4,1,4,9,Loyal
GH-14485,2016/12/8,387,2,1361.24,1,1,2,4,Risk
GH-14665,2017/12/28,2,2,146.94,5,1,1,7,Potential
GK-14620,2017/9/9,112,9,6497.28,2,5,5,12,Loyal
GM-14440,2017/10/8,83,7,3582.82,3,3,4,10,Loyal
GM-14455,2017/12/14,16,6,3078.63,5,3,4,12,Loyal
GM-14500,2017/9/15,106,10,1255.68,2,5,2,9,Loyal
GM-14680,2017/7/31,152,6,3163.63,2,3,4,9,Loyal
GM-14695,2017/9/4,117,3,6049.96,2,1,5,8,Potential
GP-14740,2015/11/26,765,2,236.53,1,1,1,3,Risk
GR-14560,2014/11/21,1135,2,1284.38,1,1,2,4,Risk
GT-14635,2017/11/4,56,3,9351.2,3,1,5,9,Loyal
GT-14710,2017/11/24,36,11,11820.12,4,5,5,14,VIP
GT-14755,2017/11/26,34,4,226.43,4,1,1,6,Potential
GW-14605,2017/12/2,28,7,2189.02,4,3,3,10,Loyal
GZ-14470,2017/12/23,7,9,4355.15,5,5,5,15,VIP
GZ-14545,2017/7/26,157,4,2454.62,2,1,3,6,Potential
HA-14905,2017/10/22,69,7,2163.32,3,3,3,9,Loyal
HA-14920,2017/12/10,20,8,2584.17,5,4,3,12,Loyal
HD-14785,2015/11/22,769,3,251.36,1,1,1,3,Risk
HE-14800,2017/12/18,12,4,883.53,5,1,1,7,Potential
HF-14995,2017/12/9,21,7,2533.16,5,4,3,12,Loyal
HG-14845,2017/11/6,54,5,785.62,3,2,1,6,Potential
HG-14965,2017/12/7,23,12,3247.65,5,5,4,14,VIP
HG-15025,2017/12/24,6,7,3690.28,5,4,4,13,VIP
HH-15010,2017/10/19,72,2,218.67,3,1,1,5,Risk
HJ-14875,2017/8/26,126,5,358.1,2,2,1,5,Risk
HK-14890,2017/8/1,151,8,4877.8,2,4,5,11,Loyal
HL-15040,2017/11/17,43,6,12873.3,4,3,5,12,Loyal
HM-14860,2017/12/28,2,10,8236.76,5,5,5,15,VIP
HM-14980,2017/4/27,247,4,736.28,1,1,1,3,Risk
HP-14815,2017/11/30,30,7,1990.31,4,4,3,11,Loyal
HR-14770,2017/12/17,13,5,1299.29,5,2,2,9,Loyal
HR-14830,2017/7/24,159,7,5248.8,2,4,5,11,Loyal
HW-14935,2017/9/4,117,8,9300.25,2,4,5,11,Loyal
HZ-14950,2017/11/25,35,5,886.52,4,2,1,7,Potential
IG-15085,2017/10/20,71,4,744.57,3,1,1,5,Risk
IL-15100,2017/8/10,142,7,5040.74,2,4,5,11,Loyal
IM-15055,2016/11/16,409,3,2872.63,1,1,4,6,Potential
IM-15070,2016/12/5,390,7,4930.49,1,4,5,10,Loyal
JA-15970,2017/9/29,92,8,6491.03,3,4,5,12,Loyal
JB-15400,2017/12/23,7,10,1791.62,5,5,3,13,VIP
JB-15925,2015/12/24,737,3,900.55,1,1,1,3,Risk
JB-16000,2017/11/17,43,7,644.12,4,4,1,9,Loyal
JB-16045,2017/12/23,7,5,2518.11,5,2,3,10,Loyal
JC-15340,2017/9/7,114,4,71.27,2,1,1,4,Risk
JC-15385,2017/7/8,175,1,1058.11,2,1,2,5,Risk
JC-15775,2017/7/25,158,9,2772.06,2,5,4,11,Loyal
JC-16105,2017/11/3,57,5,858.57,3,2,1,6,Potential
JD-15790,2017/9/4,117,5,2152.35,2,2,3,7,Potential
JD-15895,2016/12/1,394,11,7610.87,1,5,5,11,Loyal
JD-16015,2017/9/9,112,6,385.43,2,3,1,6,Potential
JD-16060,2017/3/5,300,3,695.44,1,1,1,3,Risk
JD-16150,2017/11/19,41,8,8828.04,4,4,5,13,VIP
JE-15475,2017/6/20,193,6,1388.69,2,3,2,7,Potential
JE-15610,2017/11/12,48,7,7754.97,4,4,5,13,VIP
JE-15715,2017/11/14,46,10,8697.86,4,5,5,14,VIP
JE-15745,2017/11/9,51,13,6760.81,4,5,5,14,VIP
JE-16165,2017/12/10,20,3,2697.25,5,1,3,9,Loyal
JF-15190,2017/10/26,65,7,2279.59,3,4,3,10,Loyal
JF-15295,2017/5/19,225,5,955.12,1,2,1,4,Risk
JF-15355,2017/9/16,105,6,1911.84,2,3,3,8,Potential
JF-15415,2017/12/28,2,6,2371.45,5,3,3,11,Loyal
JF-15490,2017/8/31,121,11,1082.92,2,5,2,9,Loyal
JF-15565,2017/11/6,54,8,4198.32,3,4,4,11,Loyal
JG-15115,2015/12/3,758,3,2358.66,1,1,3,5,Risk
JG-15160,2017/12/29,1,11,6366.4,5,5,5,15,VIP
JG-15310,2017/12/28,2,6,2240.58,5,3,3,11,Loyal
JG-15805,2017/5/21,223,6,1507.02,2,3,2,7,Potential
JH-15430,2017/12/25,5,4,309.29,5,1,1,7,Potential
JH-15820,2017/7/9,174,6,528.92,2,3,1,6,Potential
JH-15910,2017/11/19,41,7,959.48,4,4,1,9,Loyal
JH-15985,2017/12/1,29,6,7954.99,4,3,5,12,Loyal
JH-16180,2016/11/21,404,4,2256.39,1,1,3,5,Risk
JJ-15445,2016/9/3,483,5,709.17,1,2,1,4,Risk
JJ-15760,2015/12/8,753,2,195,1,1,1,3,Risk
JK-15205,2017/10/30,61,5,4427.14,3,2,5,10,Loyal
JK-15325,2017/3/18,287,3,383.81,1,1,1,3,Risk
JK-15370,2017/11/16,44,8,2709.62,4,4,3,11,Loyal
JK-15625,2017/10/30,61,7,3760.03,3,4,4,11,Loyal
JK-15640,2017/7/3,180,9,4760.44,2,5,5,12,Loyal
JK-15730,2017/10/7,84,10,4867.21,3,5,5,13,VIP
JK-16090,2017/12/2,28,3,3747.66,4,1,4,9,Loyal
JK-16120,2017/9/4,117,10,2932.49,2,5,4,11,Loyal
JL-15130,2017/12/22,8,6,1214.95,5,3,2,10,Loyal
JL-15175,2017/12/24,6,5,1563.86,5,2,2,9,Loyal
JL-15235,2017/9/2,119,5,2203.7,2,2,3,7,Potential
JL-15505,2017/11/11,49,6,3144.47,4,3,4,11,Loyal
JL-15835,2017/12/9,21,11,9799.94,5,5,5,15,VIP
JL-15850,2016/4/25,614,6,2725.25,1,3,3,7,Potential
JM-15250,2017/11/23,37,6,3147.63,4,3,4,11,Loyal
JM-15265,2017/11/23,37,5,1804.14,4,2,3,9,Loyal
JM-15535,2017/9/19,102,7,1733.45,3,4,2,9,Loyal
JM-15580,2017/12/30,0,5,303.94,5,2,1,8,Potential
JM-15655,2017/12/22,8,5,864.95,5,2,1,8,Potential
JM-15865,2017/9/12,109,7,7625.07,2,4,5,11,Loyal
JM-16195,2017/11/3,57,10,2833.92,3,5,4,12,Loyal
JO-15145,2017/11/3,57,9,3254.95,3,5,4,12,Loyal
JO-15280,2017/9/29,92,6,1934.27,3,3,3,9,Loyal
JO-15550,2017/5/29,215,5,1090.85,2,2,2,6,Potential
JP-15460,2017/11/23,37,7,1669.13,4,4,2,10,Loyal
JP-15520,2017/12/22,8,7,3612.07,5,4,4,13,VIP
JP-16135,2017/9/19,102,9,1707.71,3,5,2,10,Loyal
JR-15670,2016/5/16,593,2,1156.66,1,1,2,4,Risk
JR-15700,2017/10/23,68,1,863.88,3,1,1,5,Risk
JR-16210,2017/11/27,33,5,2201.69,4,2,3,9,Loyal
JS-15595,2017/9/2,119,4,1417.65,2,1,2,5,Risk
JS-15685,2017/11/18,42,4,1131.07,4,1,2,7,Potential
JS-15880,2016/7/14,534,5,3868.01,1,2,4,7,Potential
JS-15940,2016/9/23,463,5,469.16,1,2,1,4,Risk
JS-16030,2017/12/2,28,6,2516.49,4,3,3,10,Loyal
JW-15220,2017/11/18,42,6,7721.71,4,3,5,12,Loyal
JW-15955,2017/12/25,5,7,1244.09,5,4,2,11,Loyal
JW-16075,2016/9/25,461,4,1428.73,1,1,2,4,Risk
KA-16525,2017/11/24,36,7,1519.51,4,4,2,10,Loyal
KB-16240,2017/12/26,4,7,3152.61,5,4,4,13,VIP
KB-16315,2017/3/9,296,9,1569.45,1,5,2,8,Potential
KB-16405,2017/9/4,117,3,908.82,2,1,1,4,Risk
KB-16585,2017/5/14,230,12,2744.74,1,5,3,9,Loyal
KB-16600,2017/12/29,1,7,983.93,5,4,2,11,Loyal
KC-16255,2016/11/18,407,6,2120.95,1,3,3,7,Potential
KC-16540,2017/9/24,97,4,3908.27,3,1,4,8,Potential
KC-16675,2017/11/3,57,4,1146.05,3,1,2,6,Potential
KD-16270,2016/9/2,484,5,8282.36,1,2,5,8,Potential
KD-16345,2017/11/19,41,6,1888.96,4,3,3,10,Loyal
KD-16495,2017/9/9,112,12,8181.24,2,5,5,12,Loyal
KD-16615,2017/3/16,289,5,2243.51,1,2,3,6,Potential
KE-16420,2017/12/4,26,8,1686.73,5,4,2,11,Loyal
KF-16285,2017/9/24,97,7,10604.26,3,4,5,12,Loyal
KH-16330,2017/11/20,40,8,3312.87,4,4,4,12,Loyal
KH-16360,2017/12/29,1,6,3096.77,5,3,4,12,Loyal
KH-16510,2017/12/8,22,7,5952.86,5,4,5,14,VIP
KH-16630,2017/11/2,58,9,3918.96,3,5,4,12,Loyal
KH-16690,2017/12/28,2,7,5990.79,5,4,5,14,VIP
KL-16555,2017/12/14,16,8,5016.47,5,4,5,14,VIP
KL-16645,2017/11/13,47,12,14139.95,4,5,5,14,VIP
KM-16225,2017/12/16,14,6,2260.95,5,3,3,11,Loyal
KM-16375,2017/11/4,56,8,5620.18,3,4,5,12,Loyal
KM-16660,2017/12/15,15,5,453.54,5,2,1,8,Potential
KM-16720,2017/12/2,28,8,4909.47,4,4,5,13,VIP
KN-16390,2017/12/11,19,9,2617.29,5,5,3,13,VIP
KN-16450,2017/11/8,52,5,2171.97,4,2,3,9,Loyal
KN-16705,2017/9/23,98,8,2280.58,3,4,3,10,Loyal
KS-16300,2017/3/10,295,3,88.47,1,1,1,3,Risk
KT-16465,2016/12/4,391,7,3057.1,1,4,4,9,Loyal
KT-16480,2017/9/21,100,10,4642.1,3,5,5,13,VIP
KW-16435,2017/9/25,96,5,4416.52,3,2,5,10,Loyal
KW-16570,2015/11/20,771,4,449.1,1,1,1,3,Risk
LA-16780,2017/7/29,154,11,8673.23,2,5,5,12,Loyal
LB-16735,2017/11/12,48,3,50.19,4,1,1,6,Potential
LB-16795,2017/7/31,152,8,4985.68,2,4,5,11,Loyal
LC-16870,2017/12/3,27,8,2580.71,4,4,3,11,Loyal
LC-16885,2017/12/14,16,12,7663.13,5,5,5,15,VIP
LC-16930,2017/11/19,41,8,4492.94,4,4,5,13,VIP
LC-16960,2016/10/20,436,4,3246.63,1,1,4,6,Potential
LC-17050,2017/11/6,54,5,2095.06,3,2,3,8,Potential
LC-17140,2017/12/17,13,9,2633.57,5,5,3,13,VIP
LD-16855,2016/6/26,552,1,5.3,1,1,1,3,Risk
LD-17005,2016/11/11,414,4,1961.93,1,1,3,5,Risk
LE-16810,2017/12/9,21,6,1469.45,5,3,2,10,Loyal
LF-17185,2017/12/8,22,7,3930.52,5,4,4,13,VIP
LH-16750,2017/8/1,151,3,287.43,2,1,1,4,Risk
LH-16900,2017/12/9,21,9,2295.32,5,5,3,13,VIP
LH-17020,2017/5/5,239,4,318.23,1,1,1,3,Risk
LH-17155,2016/12/10,385,9,1739.69,1,5,3,9,Loyal
LL-16840,2017/4/25,249,6,2741.2,1,3,3,7,Potential
LM-17065,2016/12/4,391,5,1346.78,1,2,2,5,Risk
LO-17170,2017/12/28,2,5,644.35,5,2,1,8,Potential
LP-17080,2017/11/20,40,4,725.16,4,1,1,6,Potential
LP-17095,2017/12/21,9,7,3653.4,5,4,4,13,VIP
LR-16915,2017/12/4,26,6,5142.89,5,3,5,13,VIP
LR-17035,2017/8/20,132,5,1879.3,2,2,3,7,Potential
LS-16945,2017/7/5,178,6,2845.27,2,3,4,9,Loyal
LS-16975,2017/12/10,20,9,2988.65,5,5,4,14,VIP
LS-17200,2017/9/25,96,6,1010.25,3,3,2,8,Potential
LS-17230,2015/11/14,777,3,368.88,1,1,1,3,Risk
LS-17245,2017/11/26,34,6,1008.14,4,3,2,9,Loyal
LT-16765,2017/12/4,26,3,329.87,5,1,1,7,Potential
LT-17110,2017/11/26,34,8,2936.26,4,4,4,12,Loyal
LW-16825,2017/10/3,88,5,2238.06,3,2,3,8,Potential
LW-16990,2017/11/27,33,6,3230.3,4,3,4,11,Loyal
LW-17125,2017/6/8,205,3,1259.04,2,1,2,5,Risk
LW-17215,2017/12/9,21,7,5420.52,5,4,5,14,VIP
MA-17560,2017/10/27,64,11,4263.88,3,5,4,12,Loyal
MA-17995,2017/6/27,186,6,2453.29,2,3,3,8,Potential
MB-17305,2017/11/12,48,10,1548.71,4,5,2,11,Loyal
MB-18085,2017/11/16,44,7,1428.24,4,4,2,10,Loyal
MC-17275,2017/10/15,76,8,2725.98,3,4,3,10,Loyal
MC-17425,2016/11/26,399,5,4432.14,1,2,5,8,Potential
MC-17575,2017/12/3,27,8,1303.89,4,4,2,10,Loyal
MC-17590,2017/11/9,51,6,2426.07,4,3,3,10,Loyal
MC-17605,2017/9/9,112,8,2258.2,2,4,3,9,Loyal
MC-17635,2017/6/24,189,4,795.15,2,1,1,4,Risk
MC-17845,2017/12/29,1,7,3805.71,5,4,4,13,VIP
MC-18100,2017/11/19,41,10,2218.99,4,5,3,12,Loyal
MC-18130,2016/12/26,369,5,1581.99,1,2,2,5,Risk
MD-17350,2017/9/4,117,7,3766.4,2,4,4,10,Loyal
MD-17860,2017/11/24,36,5,1204.91,4,2,2,8,Potential
ME-17320,2017/11/18,42,10,10663.73,4,5,5,14,VIP
ME-17725,2017/12/2,28,8,1908.45,4,4,3,11,Loyal
ME-18010,2017/9/29,92,4,1256.95,3,2,2,7,Potential
MF-17665,2016/11/4,421,5,937.05,1,2,1,4,Risk
MF-18250,2017/12/23,7,5,1758.3,5,2,3,10,Loyal
MG-17650,2017/12/1,29,7,3785.28,4,4,4,12,Loyal
MG-17680,2017/9/29,92,4,2350.2,3,2,3,8,Potential
MG-17695,2016/6/23,555,3,1342.29,1,1,2,4,Risk
MG-17875,2017/9/5,116,5,1242.84,2,2,2,6,Potential
MG-17890,2017/9/22,99,9,776.39,3,5,1,9,Loyal
MG-18145,2017/10/7,84,4,3061.54,3,2,4,9,Loyal
MG-18205,2017/4/10,264,1,16.74,1,1,1,3,Risk
MH-17290,2017/9/2,119,6,2394.02,2,3,3,8,Potential
MH-17440,2016/12/19,376,4,400.02,1,2,1,4,Risk
MH-17455,2017/10/6,85,8,2456.18,3,4,3,10,Loyal
MH-17620,2017/7/28,155,4,1252.8,2,2,2,6,Potential
MH-17785,2017/9/23,98,7,2203.78,3,4,3,10,Loyal
MH-18025,2017/11/11,49,5,2984.95,4,2,4,10,Loyal
MH-18115,2017/12/25,5,9,5503.09,5,5,5,15,VIP
MJ-17740,2017/12/8,22,7,6320.75,5,4,5,14,VIP
MK-17905,2017/12/2,28,8,2302.36,4,4,3,11,Loyal
MK-18160,2017/5/4,240,4,1031.6,1,2,2,5,Risk
ML-17395,2017/10/22,69,9,2722.84,3,5,3,11,Loyal
ML-17410,2017/11/6,54,6,2921.51,3,3,4,10,Loyal
ML-17755,2017/12/1,29,7,2071.91,4,4,3,11,Loyal
ML-18040,2017/10/12,79,3,742.08,3,1,1,5,Risk
ML-18265,2017/9/21,100,2,162.23,3,1,1,5,Risk
MM-17260,2017/7/15,168,4,1314.02,2,2,2,6,Potential
MM-17920,2017/12/23,7,11,3794.07,5,5,4,14,VIP
MM-18055,2017/10/30,61,8,2728.91,3,4,3,10,Loyal
MM-18280,2017/10/6,85,9,775.41,3,5,1,9,Loyal
MN-17935,2017/11/26,34,6,2477.94,4,3,3,10,Loyal
MO-17500,2017/10/19,72,4,922.49,3,2,1,6,Potential
MO-17800,2017/9/17,104,8,1687.03,2,4,2,8,Potential
MO-17950,2017/7/3,180,2,154.29,2,1,1,4,Risk
MP-17470,2016/1/11,719,7,3206.12,1,4,4,9,Loyal
MP-17965,2017/10/19,72,9,3983.65,3,5,4,12,Loyal
MP-18175,2017/12/14,16,9,5087.93,5,5,5,15,VIP
MR-17545,2017/8/27,125,4,639.18,2,2,1,5,Risk
MS-17365,2017/4/1,273,10,7443.68,1,5,5,11,Loyal
MS-17530,2016/10/22,434,4,475.66,1,2,1,4,Risk
MS-17710,2016/11/12,413,6,1613.39,1,3,2,6,Potential
MS-17770,2017/8/31,121,9,3144.67,2,5,4,11,Loyal
MS-17830,2016/10/4,452,4,370.34,1,2,1,4,Risk
MS-17980,2017/12/4,26,6,855.12,5,3,1,9,Loyal
MT-17815,2017/11/11,49,6,2890.14,4,3,4,11,Loyal
MT-18070,2017/6/10,203,4,1319.44,2,2,2,6,Potential
MV-17485,2017/12/3,27,9,1560.03,4,5,2,11,Loyal
MV-18190,2017/12/11,19,7,1734.58,5,4,2,11,Loyal
MW-18220,2017/12/13,17,7,5341.9,5,4,5,14,VIP
MW-18235,2017/11/16,44,2,5253.88,4,1,5,10,Loyal
MY-17380,2017/12/1,29,7,2254.29,4,4,3,11,Loyal
MY-18295,2017/10/20,71,11,4152.7,3,5,4,12,Loyal
MZ-17335,2017/11/30,30,4,593.61,4,2,1,7,Potential
MZ-17515,2017/3/23,282,6,2564.89,1,3,3,7,Potential
NB-18580,2014/10/22,1165,2,273.87,1,1,1,3,Risk
NB-18655,2017/12/11,19,9,1972.61,5,5,3,13,VIP
NC-18340,2017/5/20,224,5,2461.41,2,2,3,7,Potential
NC-18415,2017/11/19,41,6,2218.99,4,3,3,10,Loyal
NC-18535,2017/12/24,6,7,8241.74,5,4,5,14,VIP
NC-18625,2017/6/9,204,5,1821.75,2,2,3,7,Potential
ND-18370,2017/12/3,27,9,4326.14,4,5,5,14,VIP
ND-18460,2017/6/30,183,6,2893.46,2,3,4,9,Loyal
NF-18385,2017/10/12,79,7,8322.82,3,4,5,12,Loyal
NF-18475,2016/7/23,525,4,377.17,1,2,1,4,Risk
NF-18595,2017/9/7,114,7,2031.48,2,4,3,9,Loyal
NG-18355,2017/11/12,48,5,1869.57,4,2,3,9,Loyal
NG-18430,2017/11/12,48,5,1395.94,4,2,2,8,Potential
NH-18610,2017/6/24,189,7,2673.29,2,4,3,9,Loyal
NK-18490,2017/10/21,70,7,572.05,3,4,1,8,Potential
NL-18310,2017/11/2,58,4,1418.08,3,2,2,7,Potential
NM-18445,2017/7/23,160,7,6459.34,2,4,5,11,Loyal
NM-18520,2017/4/30,244,10,2161.98,1,5,3,9,Loyal
NP-18325,2017/12/5,25,6,5529.62,5,3,5,13,VIP
NP-18670,2017/11/2,58,5,3908.4,3,2,4,9,Loyal
NP-18685,2016/11/19,406,6,1228.7,1,3,2,6,Potential
NP-18700,2017/8/14,138,7,7903.18,2,4,5,11,Loyal
NR-18550,2017/6/3,210,5,2367.27,2,2,3,7,Potential
NS-18505,2017/12/24,6,4,2575.87,5,2,3,10,Loyal
NS-18640,2017/7/9,174,13,2964.82,2,5,4,11,Loyal
NW-18400,2017/7/11,172,7,7234.02,2,4,5,11,Loyal
NZ-18565,2017/10/6,85,9,2488.33,3,5,3,11,Loyal
ON-18715,2016/11/15,410,9,1567.52,1,5,2,8,Potential
OT-18730,2017/10/26,65,5,3818.62,3,2,4,9,Loyal
PA-19060,2017/9/18,103,6,729.41,3,3,1,7,Potential
PB-18805,2017/12/5,25,3,740.36,5,1,1,7,Potential
PB-19105,2017/11/3,57,4,688.33,3,2,1,6,Potential
PB-19150,2017/9/24,97,8,1456.95,3,4,2,9,Loyal
PB-19210,2016/2/11,688,2,132.74,1,1,1,3,Risk
PC-18745,2017/12/28,2,4,1832.07,5,2,3,10,Loyal
PC-19000,2015/8/1,882,2,1061.49,1,1,2,4,Risk
PF-19120,2015/9/17,835,4,9062.86,1,2,5,8,Potential
PF-19165,2017/6/17,196,6,2770,2,3,4,9,Loyal
PF-19225,2017/9/7,114,5,2206.12,2,2,3,7,Potential
PG-18820,2017/11/24,36,13,3086.9,4,5,4,13,VIP
PG-18895,2017/11/3,57,9,1987.15,3,5,3,11,Loyal
PH-18790,2017/10/21,70,1,729.65,3,1,1,5,Risk
PJ-18835,2017/11/21,39,8,1220.1,4,4,2,10,Loyal
PJ-19015,2017/8/18,134,7,1824.23,2,4,3,9,Loyal
PK-18910,2016/9/3,483,2,1441.15,1,1,2,4,Risk
PK-19075,2017/12/21,9,12,8646.93,5,5,5,15,VIP
PL-18925,2017/12/15,15,5,239.49,5,2,1,8,Potential
PM-18940,2016/12/9,386,3,1405.4,1,1,2,4,Risk
PM-19135,2017/11/9,51,4,4115.66,4,2,4,10,Loyal
PN-18775,2017/11/30,30,8,1467.16,4,4,2,10,Loyal
PO-18850,2017/12/26,4,11,7473.84,5,5,5,15,VIP
PO-18865,2017/12/30,0,7,2493.22,5,4,3,12,Loyal
PO-19180,2017/7/23,160,9,4893.05,2,5,5,12,Loyal
PO-19195,2017/10/5,86,5,1056.85,3,2,2,7,Potential
PP-18955,2017/9/24,97,10,7252.61,3,5,5,13,VIP
PR-18880,2017/11/24,36,5,1840.18,4,2,3,9,Loyal
PS-18760,2017/9/14,107,6,2181.48,2,3,3,8,Potential
PS-18970,2017/10/22,69,8,1278.65,3,4,2,9,Loyal
PS-19045,2017/5/8,236,7,6843.63,1,4,5,10,Loyal
PT-19090,2017/10/20,71,4,160.58,3,2,1,6,Potential
PV-18985,2017/10/2,89,5,2876.05,3,2,4,9,Loyal
PW-19030,2017/11/14,46,10,3443.15,4,5,4,13,VIP
PW-19240,2016/9/22,464,7,3922.41,1,4,4,9,Loyal
QJ-19255,2017/12/5,25,9,6108.34,5,5,5,15,VIP
RA-19285,2017/12/25,5,9,2617.89,5,5,3,13,VIP
RA-19885,2017/11/17,43,7,3832.32,4,4,4,12,Loyal
RA-19915,2017/12/18,12,9,4793.53,5,5,5,15,VIP
RA-19945,2017/10/30,61,5,1686.93,3,2,2,7,Potential
RB-19330,2017/10/23,68,2,1008.2,3,1,2,6,Potential
RB-19360,2017/9/25,96,6,15117.35,3,3,5,11,Loyal
RB-19435,2017/12/11,19,8,2663.07,5,4,3,12,Loyal
RB-19465,2017/12/21,9,12,4715.47,5,5,5,15,VIP
RB-19570,2017/12/5,25,5,528.53,5,2,1,8,Potential
RB-19645,2016/3/22,648,5,221.09,1,2,1,4,Risk
RB-19705,2017/11/6,54,4,2067.45,3,2,3,8,Potential
RB-19795,2017/11/28,32,8,5633.31,4,4,5,13,VIP
RC-19825,2016/12/26,369,6,966.41,1,3,2,6,Potential
RC-19960,2017/9/11,110,6,885.75,2,3,1,6,Potential
RD-19480,2017/10/19,72,8,4272.94,3,4,4,11,Loyal
RD-19585,2017/7/3,180,10,2912.9,2,5,4,11,Loyal
RD-19660,2017/9/7,114,5,2786.63,2,2,4,8,Potential
RD-19720,2017/12/9,21,10,1419.74,5,5,2,12,Loyal
RD-19810,2017/12/16,14,8,1137.61,5,4,2,11,Loyal
RD-19900,2017/9/7,114,9,3133.92,2,5,4,11,Loyal
RD-19930,2017/11/18,42,4,970.95,4,2,2,8,Potential
RE-19405,2014/12/29,1097,1,48.36,1,1,1,3,Risk
RE-19450,2017/3/3,302,5,876.7,1,2,1,4,Risk
RF-19345,2016/12/5,390,8,3309.14,1,4,4,9,Loyal
RF-19735,2017/10/2,89,7,2341.3,3,4,3,10,Loyal
RF-19840,2017/12/24,6,8,945.22,5,4,1,10,Loyal
RH-19495,2017/11/28,32,5,3621.38,4,2,4,10,Loyal
RH-19510,2016/9/19,467,6,6979.18,1,3,5,9,Loyal
RH-19555,2016/7/29,519,2,740.39,1,1,1,3,Risk
RH-19600,2016/7/14,534,3,2076.57,1,1,3,5,Risk
RK-19300,2017/9/2,119,3,1460.19,2,1,2,5,Risk
RL-19615,2017/8/31,121,8,6234.91,2,4,5,11,Loyal
RM-19375,2017/1/19,345,6,1453.47,1,3,2,6,Potential
RM-19675,2017/12/24,6,5,5979.09,5,2,5,12,Loyal
RM-19750,2017/3/6,299,1,98.35,1,1,1,3,Risk
RO-19780,2017/11/25,35,7,3815.47,4,4,4,12,Loyal
RP-19270,2016/8/21,496,4,954.64,1,2,1,4,Risk
RP-19390,2017/11/27,33,12,5153.06,4,5,5,14,VIP
RP-19855,2017/12/2,28,8,2170.71,4,4,3,11,Loyal
RR-19315,2017/12/11,19,2,615.93,5,1,1,7,Potential
RR-19525,2017/7/13,170,6,3302.26,2,3,4,9,Loyal
RS-19420,2017/10/15,76,5,3221.29,3,2,4,9,Loyal
RS-19765,2017/11/24,36,8,4159.77,4,4,4,12,Loyal
RS-19870,2017/12/11,19,2,22.33,5,1,1,7,Potential
RW-19540,2017/9/1,120,7,7397.4,2,4,5,11,Loyal
RW-19630,2017/10/2,89,9,3279.75,3,5,4,12,Loyal
RW-19690,2017/10/12,79,5,3495.64,3,2,4,9,Loyal
SA-20830,2017/10/28,63,10,4767.34,3,5,5,13,VIP
SB-20170,2017/6/12,201,3,1348.02,2,1,2,5,Risk
SB-20185,2017/6/25,188,6,6411,2,3,5,10,Loyal
SB-20290,2017/11/13,47,7,8057.89,4,4,5,13,VIP
SC-20020,2015/11/10,781,5,3362.96,1,2,4,7,Potential
SC-20050,2017/11/20,40,9,4624.57,4,5,5,14,VIP
SC-20095,2017/1/15,349,9,14142.34,1,5,5,11,Loyal
SC-20230,2017/8/3,149,4,4371.96,2,2,5,9,Loyal
SC-20260,2017/6/26,187,8,3729.8,2,4,4,10,Loyal
SC-20305,2017/12/1,29,7,3979.06,4,4,4,12,Loyal
SC-20380,2017/11/30,30,9,5992.53,4,5,5,14,VIP
SC-20440,2017/11/24,36,7,1875,4,4,3,11,Loyal
SC-20575,2017/9/29,92,5,902.73,3,2,1,6,Potential
SC-20680,2017/8/26,126,6,1254.64,2,3,2,7,Potential
SC-20695,2017/10/2,89,10,2576.4,3,5,3,11,Loyal
SC-20725,2017/6/26,187,11,5226.2,2,5,5,12,Loyal
SC-20770,2017/11/19,41,7,4492.68,4,4,5,13,VIP
SC-20800,2017/11/30,30,4,279.25,4,2,1,7,Potential
SC-20845,2017/8/21,131,2,280.63,2,1,1,4,Risk
SD-20485,2017/6/13,200,9,6121.1,2,5,5,12,Loyal
SE-20110,2017/12/21,9,11,12209.44,5,5,5,15,VIP
SF-20065,2017/11/1,59,7,763.54,3,4,1,8,Potential
SF-20200,2017/11/1,59,9,3422.78,3,5,4,12,Loyal
SF-20965,2017/11/12,48,9,3336.53,4,5,4,13,VIP
SG-20080,2017/12/22,8,3,3406.58,5,1,4,10,Loyal
SG-20470,2017/6/30,183,8,1884.8,2,4,3,9,Loyal
SG-20605,2017/9/13,108,6,3124.84,2,3,4,9,Loyal
SG-20890,2017/5/18,226,3,47.95,1,1,1,3,Risk
SH-19975,2017/12/1,29,13,3406.86,4,5,4,13,VIP
SH-20395,2017/12/7,23,10,2180.7,5,5,3,13,VIP
SH-20635,2015/11/26,765,2,2096.39,1,1,3,5,Risk
SJ-20125,2017/9/26,95,12,3949.65,3,5,4,12,Loyal
SJ-20215,2017/12/1,29,6,1341.04,4,3,2,9,Loyal
SJ-20500,2017/4/21,253,5,1318.77,1,2,2,5,Risk
SK-19990,2017/12/22,8,3,883.41,5,1,1,7,Potential
SL-20155,2017/10/21,70,7,3053.01,3,4,4,11,Loyal
SM-20005,2016/11/4,421,4,244.49,1,2,1,4,Risk
SM-20320,2017/10/12,79,5,25043.07,3,2,5,10,Loyal
SM-20905,2016/5/3,606,1,1043.05,1,1,2,4,Risk
SM-20950,2017/12/5,25,12,5563.4,5,5,5,15,VIP
SN-20560,2017/9/10,111,6,1860.42,2,3,3,8,Potential
SN-20710,2017/10/12,79,7,3127.97,3,4,4,11,Loyal
SO-20335,2017/12/1,29,6,2602.58,4,3,3,10,Loyal
SP-20545,2017/2/6,327,6,1306.09,1,3,2,6,Potential
SP-20620,2017/11/13,47,9,5440.32,4,5,5,14,VIP
SP-20650,2016/12/9,386,9,1872.43,1,5,3,9,Loyal
SP-20860,2017/10/12,79,10,4282.92,3,5,5,13,VIP
SP-20920,2017/10/21,70,6,3990.67,3,3,4,10,Loyal
SR-20425,2017/12/22,8,5,3233.48,5,2,4,11,Loyal
SR-20740,2017/6/17,196,8,4345.88,2,4,5,11,Loyal
SS-20140,2017/12/15,15,8,1324.03,5,4,2,11,Loyal
SS-20410,2017/9/11,110,6,3056.81,2,3,4,9,Loyal
SS-20515,2016/8/26,491,3,613.4,1,1,1,3,Risk
SS-20590,2016/10/24,432,6,418.49,1,3,1,5,Risk
SS-20875,2017/9/1,120,5,964.63,2,2,2,6,Potential
ST-20530,2017/8/27,125,7,420.16,2,4,1,7,Potential
SU-20665,2017/12/10,20,7,2595.38,5,4,3,12,Loyal
SV-20365,2017/9/20,101,10,11459.18,3,5,5,13,VIP
SV-20785,2017/2/13,320,9,4105.32,1,5,4,10,Loyal
SV-20815,2017/10/15,76,4,1271.09,3,2,2,7,Potential
SV-20935,2017/12/28,2,8,1903.49,5,4,3,12,Loyal
SW-20245,2017/10/10,81,7,1085.06,3,4,2,9,Loyal
SW-20275,2017/11/30,30,6,1966.65,4,3,3,10,Loyal
SW-20350,2017/7/21,162,3,1019.04,2,1,2,5,Risk
SW-20455,2017/7/21,162,7,2921.54,2,4,4,10,Loyal
SW-20755,2016/7/14,534,2,758.69,1,1,1,3,Risk
SZ-20035,2017/11/25,35,11,3625.34,4,5,4,13,VIP
TA-21385,2017/10/22,69,4,14595.62,3,2,5,10,Loyal
TB-21055,2017/9/2,119,5,1467.89,2,2,2,6,Potential
TB-21175,2017/11/2,58,4,3589.29,3,2,4,9,Loyal
TB-21190,2017/11/11,49,4,816.17,4,2,1,7,Potential
TB-21250,2017/1/15,349,7,1602.37,1,4,2,7,Potential
TB-21280,2016/5/26,583,6,2198.46,1,3,3,7,Potential
TB-21355,2017/8/6,146,5,834.33,2,2,1,5,Risk
TB-21400,2017/6/11,202,7,9133.99,2,4,5,11,Loyal
TB-21520,2017/9/14,107,9,4737.48,2,5,5,12,Loyal
TB-21595,2017/3/20,285,5,1387.57,1,2,2,5,Risk
TB-21625,2017/11/30,30,9,2797.68,4,5,4,13,VIP
TC-20980,2016/11/26,399,5,19052.22,1,2,5,8,Potential
TC-21145,2017/9/15,106,1,1038.26,2,1,2,5,Risk
TC-21295,2017/12/3,27,8,4266.81,4,4,4,12,Loyal
TC-21475,2017/7/30,153,9,1244.98,2,5,2,9,Loyal
TC-21535,2017/12/26,4,7,742.55,5,4,1,10,Loyal
TD-20995,2017/11/23,37,9,1434.56,4,5,2,11,Loyal
TG-21310,2017/1/27,337,5,3058.38,1,3,4,8,Potential
TG-21640,2017/9/7,114,4,2074.67,2,2,3,7,Potential
TH-21100,2017/1/20,344,5,2422.83,1,3,3,7,Potential
TH-21115,2017/11/2,58,4,2942.78,3,2,4,9,Loyal
TH-21235,2017/9/4,117,8,1022.21,2,4,2,8,Potential
TH-21550,2017/10/19,72,7,4234.1,3,4,4,11,Loyal
TM-21010,2017/9/18,103,8,2955.23,3,4,4,11,Loyal
TM-21490,2017/8/22,130,3,1094.68,2,1,2,5,Risk
TN-21040,2017/10/1,90,7,3130.23,3,4,4,11,Loyal
TP-21130,2017/12/22,8,9,4454.06,5,5,5,15,VIP
TP-21415,2017/9/17,104,5,5328.98,2,3,5,10,Loyal
TP-21565,2017/1/14,350,4,1936.62,1,2,3,6,Potential
TR-21325,2017/6/20,193,5,675.94,2,3,1,6,Potential
TS-21085,2017/1/7,357,2,4.84,1,1,1,3,Risk
TS-21160,2016/8/13,504,6,2163.63,1,3,3,7,Potential
TS-21205,2017/6/15,198,7,5371.11,2,4,5,11,Loyal
TS-21340,2017/5/18,226,5,974.78,1,3,2,6,Potential
TS-21370,2017/11/24,36,6,11891.75,4,3,5,12,Loyal
TS-21430,2017/7/11,172,5,2054.14,2,3,3,8,Potential
TS-21505,2017/12/19,11,6,2243.28,5,3,3,11,Loyal
TS-21610,2017/11/5,55,7,2820.42,3,4,4,11,Loyal
TS-21655,2017/5/6,238,5,3368.08,1,3,4,8,Potential
TT-21070,2017/11/29,31,7,4915.59,4,4,5,13,VIP
TT-21220,2017/6/30,183,8,1427.05,2,4,2,8,Potential
TT-21265,2016/11/19,406,3,439.5,1,1,1,3,Risk
TT-21460,2017/12/18,12,7,5364.8,5,4,5,14,VIP
TW-21025,2017/10/27,64,7,5278.82,3,4,5,12,Loyal
TZ-21580,2017/11/25,35,4,1707.28,4,2,2,8,Potential
VB-21745,2017/11/6,54,6,2005.59,3,3,3,9,Loyal
VD-21670,2016/5/28,581,6,6442.26,1,3,5,9,Loyal
VF-21715,2017/12/17,13,5,847.95,5,3,1,9,Loyal
VG-21790,2017/7/29,154,6,846.02,2,3,1,6,Potential
VG-21805,2017/3/19,286,5,427.37,1,3,1,5,Risk
VM-21685,2017/11/6,54,7,2454.87,3,4,3,10,Loyal
VM-21835,2017/9/4,117,5,380.69,2,3,1,6,Potential
VP-21730,2017/11/30,30,3,993.9,4,1,2,7,Potential
VP-21760,2017/10/16,75,7,3360.54,3,4,4,11,Loyal
VS-21820,2017/5/23,221,4,1055.99,2,2,2,6,Potential
VT-21700,2015/4/5,1000,2,1736.6,1,1,2,4,Risk
VW-21775,2017/12/2,28,10,6134.04,4,5,5,14,VIP
WB-21850,2017/12/10,20,11,6160.1,5,5,5,15,VIP
XP-21865,2017/11/17,43,11,2374.66,4,5,3,12,Loyal
YC-21895,2017/12/26,4,5,5454.35,5,3,5,13,VIP
YS-21880,2017/12/21,9,8,6720.44,5,4,5,14,VIP
ZC-21910,2017/11/6,54,13,8025.7,3,5,5,13,VIP
ZD-21925,2017/6/11,202,5,1493.94,2,3,2,7,Potential
